WWWWWWWW
WWW   WW
WX B  WW
WWW BSWW
WSWWB WW
W W S WW
WB VBBSW
W   S  W
WWWWWWWW