8
WWWWWWWW
WPW   WW
WS B   W
WWW  SWW
WSWWB WW
W  BS WW
WB VBBSW
W   S  W
WWWWWWWW